12 9
100110100
101010101
001010000
001000001
101011100
000010110
100000000
101101000
000101010
101010001
000000000
001010101